# # # # # # # # # # # # # # # # # # # # # # # # #
# # # . # # # . # # # # # # # # . . # # # # # # #
# # # . # # # . . . . # # # # # # . # # # # # # #
# # # . # # # . # # # # # # # # # . # # # # # # #
A . . . . . . . . . . . # . . . . . # # # # # # #
# # # . # # # . # # . # # # # # # . # # # # # # #
# # # . # # # . # # . # # # # # # . . . . . . # #
# # # . # . # . . . . . . . . . . . # # # # . # #
# # # . # # # # # # # # . # # # # . # # # # . # #
# # # . # # # . # # # # . # # # # . # # # # . # #
# # # . # # # . # # # # . # # # # . # # # # . # #
# # # . # # # . # # # # . # . # # . # # # # . # #
# # # . . . . . # B . . . # . # # . # # # # . # #
# # # . # # . # # # # # # # . # # # # # # # . # #
# # # # # # # # # # # # # # # # # # # # # # # # #